[console_scripts]
games-battleship = paper_games.battleship.battleship:main
games-blackjack = card_games.blackjack.blackjack:main
games-bluff = card_games.bluff.bluff:main
games-bridge = card_games.bridge.bridge:main
games-bunco = dice_games.bunco.bunco:main
games-checkers = paper_games.checkers.checkers:main
games-codebreaker = logic_games.codebreaker.codebreaker:main
games-collection = scripts.launcher:main
games-connect-four = paper_games.connect_four.connect_four:main
games-craps = dice_games.craps.craps:main
games-crazy-eights = card_games.crazy_eights.crazy_eights:main
games-cribbage = card_games.cribbage.__main__:main
games-dots-and-boxes = paper_games.dots_and_boxes.dots_and_boxes:main
games-euchre = card_games.euchre.__main__:main
games-gin-rummy = card_games.gin_rummy.gin_rummy:main
games-go-fish = card_games.go_fish.go_fish:main
games-hangman = paper_games.hangman.hangman:main
games-hearts = card_games.hearts.hearts:main
games-liars-dice = dice_games.liars_dice.liars_dice:main
games-mancala = paper_games.mancala.mancala:main
games-mastermind = logic_games.mastermind.mastermind:main
games-nim = paper_games.nim.nim:main
games-othello = paper_games.othello.othello:main
games-poker = card_games.poker.poker:main
games-rummy500 = card_games.rummy500.__main__:main
games-solitaire = card_games.solitaire.solitaire:main
games-spades = card_games.spades.spades:main
games-sudoku = paper_games.sudoku.sudoku:main
games-tic-tac-toe = paper_games.tic_tac_toe.tic_tac_toe:main
games-uno = card_games.uno.uno:main
games-unscramble = word_games.unscramble.unscramble:main
games-war = card_games.war.war:main
games-wordle = word_games.wordle.wordle:main
